00000000
00011000
00101000
00001000
00000000
00000000
00000000
00000000
